3000000000000000x
1111111111111110x
0000000000000000x
0111111111111111x
0000000000000000x
1111111111111110x
0000000000000000x
0111111111111111x
0000000000000000x
1111111111111110x
0000000000000000x
0111111111111111x
0000000000000000x
1111111111111110x
0000000000000000x
2111111111111111